01111111111111111111
4222222222X222222222
4222222222222222X222
4222TYX222X222222222
42222222222222222222
422222222TY222222222
42222222222222222222
42222222222222222222
42222222222222222222
422222X222222222TY22
4222222X222222222222
42222222222222222222
422222TY22222222TY22
42222222222222222222
42222222222222222222
4222TY22X22222X222X2
42222222222222222222
4222TY22222222222222
4222222222222222X222
63333333333333333333