11111111111111111118
22222222222222222225
222222222222222X2225
22222222222222222225
222222X222222TY22225
22222222222222222225
2222TY22222222222225
2222222222222TY22225
22222X22222222222225
22222222222222222225
2222222TY22222222225
22222222222222222225
222222222222X2222225
22222222222222222225
2222222222X222222225
222222222222222X2225
222X2222TY2222222225
2222222222222X222225
22222222222222222225
33333333333333333337